LOCATION,ELIGIBLE_OFFHIRE,LEASED,OWNED,THIRD_PARTY,TOTAL
BEANR001,20,42,341,39,442
BEANR002,42,78,657,96,873
BEANR003,33,68,526,85,712
DEHAM001,47,94,762,129,1032
DEHAM002,41,130,744,124,1039
DEHAM003,36,93,634,93,856
DEHAM004,31,84,675,110,900
DEHAM005,39,98,736,131,1004
FRLEH0001,17,57,546,84,704
FRLEH0002,42,94,630,92,858
FRLEH0003,34,108,620,92,854
FRLEH0004,42,85,620,86,833
FRLEH0005,25,58,434,80,597
